111111111111111
1000001P0000001
101110101011101
100010001010001
111011101010111
10000010101C001
101110101111101
101000101000101
101010111010101
101010100010101
101011101110101
101000001000101
101111111011101
1000001E0010001
111111111111111