1111111111111111111
100000101PC00010001
1011101010111010101
1010001010001010101
1010111011101011101
1010000010001000001
1011111011111110101
1000100010000000101
1110101110111111111
1000100000100000001
1011111111101111101
1000000010001000001
1110111010111111111
1000100010001000001
1011101110101011101
1010000000100000101
101011101E111110101
1111111111111111111