1111111111111111111
10000C101P000010001
1011101010111010101
101000101000101C101
1010111011101011101
101000001C001000001
1011111011111110101
10001000100000001C1
111C101110111111111
1000100C00100000001
1011111111101111101
10000000100C1000001
1110111010111111111
1000100010001000001
1011101110101011101
1010000000100000101
101C11101E1111101C1
1111111111111111111